

NO ./path_to_the_north_texture
SO ./path_to_the_south_texture
EA ./path_to_the_east_texture
WE ./path_to_the_west_texture


F 220,100,0
C 225,30,0


    111    1111111111111111111111111
    101    1000000000110000000000001
    111    1011000001110000000000001
           1001000000000000000000001111
11111111   1111011000001110000000000001
10000001   1000110000011101111111111111
1011111   1111110111111100010001
101         111110111   100000001
10111111111111111011111110010001
10000000110101011100000010001111
10000000000000001100000010001
1000000000000000110101001001
1100000111010101111101111N1111
11110111 1110101 101111010001
11111111 1111111 111111111111
