

NO ./path_to_the_north_texture
SO ./path_to_the_south_texture
EA ./path_to_the_east_texture
WE ./path_to_the_west_texture


F 220,100,0
C 225,30,0


111111
100001
101N001
1000001
1001001
1111111
