

NO ./cub3D_assets/eagle.xpm
SO ./cub3D_assets/greystone.xpm
WE ./cub3D_assets/purplestone.xpm
EA ./cub3D_assets/redbrick.xpm


F 100,100,100
C 0,0,100


111111
100001
101N001
1000001
1001001
1111111
